XXXXXXXXWWWXXXXWW
XXXXXXXXWBWXXXXWW
EXXXXXXCWBWSXXXWW
XXXXXXXXWWWXXXXWW
XXXXXXXXWWWXXXXWW
XXXXXXXXWWWXXXXWW
XXXXXXXXWWWXXXXWW
XXXXXXXXWWWXXXXWW
XXXXXXXXWWWXXXXXK
XXXXXXXXWWWXXXXUK
XXXXXXXXWWWXXXXWW
XXXXXXXXXXXXXXXWW
XXXXXXXXXXXXXXXWW