XXXXXXXXWWWXXXXWW
XXXXXXXXWBWXXXXWW
XXXXXXXCWBWMXXXWW
XXXXXXXXWWWXXXXWW
XXXXXXXXWWWXXXXWW
XXXXXXXXWWWXXXXWW
XXXXXXXXWWWXXXXWW
XXXXXXXXWWWXXXXWW
XXXXXXXXWWWXXXXXK
XXXXXXXXWWWXXXXUK
XXXXXXXXWWWXXXXWW
XXXXXXXXXXXXXXXWW
XXXXXXXXXXXXXXXWW