XXXXXXXWWWWXXXXWW
XXXXXXXWWBWXXXXWW
CPPPPPEWWBWMXXXWW
XXXXXXXWWWWXXXXWW
XXXXXXXWWWWXXXXWW
XXXXXXXWWWWXXXXWW
XXXXXXXWWWWXXXXWW
XXXXXXXWWWWXXXXWW
XXXXXXXWWWWXXXXXX
XXXXXXXWWWWXXUXXX
XXXXXXXWWWWXXXXWW
XXXXXXXXXXXXXXXWW
XXXXXXXXXXXXXXXWW