XXXXXXXXWWWXXXXWW
XXXXXXXXWBWXXXXWW
CPPPPPPPWBWMXXXWW
XXXXXXXXWWWXXXXWW
XXXXXXXXWWWXXXXWW
XXXXXXXXWWWXXXXWW
XXXXXXXXWWWXXXXWW
XXXXXXXXWWWXXXXWW
XXXXXXXXWWWXXXXXX
XXXXXXXXWWWXXUXXX
XXXXXXXXWWWXXXXWW
XXXXXXXXXXXXXXXWW
XXXXXXXXXXXXXXXWW