XXXXXXXXWWWXXXXWW
XXXXXXXXWWWXXXXWW
CPPPPPPPWBWMXXXWW
XXXXXXXXWWWXXXXWW
XXXXXXXXWWWXXXXWW
XXXXXXXXWWWXXXXWW
XXXXXXXXWWWXXXXWW
XXXXXXXXWWWXXXXWW
XXXXXXXXWWWXXXXXK
XXXXXXXXWWWXXUXXK
XXXXXXXXWWWXXXXWW
XXXXXXXXXXXXXXXWW
XXXXXXXXXXXXXXXWW